111111111111_____111111111111_____111111111111
1__________1_____1__________1_____1__________1
1__________1_____1__________1_____1__________1
1__________1_____1__________1_____1__________1
1_________311111113________311111113_________1
1____________________________________________1
1____________________________________________1
1_________311111113________311111113_________1
1__________1_____1__________1_____1__________1
1__________1_____1__________1_____1__________1
1___3__3___1_____1__________1_____1___3__3___1
11111__11111_____111111111111_____11111__11111
____1__1______________________________1__1____
____1__1______________________________1__1____
____1__1______________________________1__1____
____1__1______________________________1__1____
____1__1______________________________1__1____
11111__11111______________________11111__11111
1___3__3___1______________________1___3__3___1
1__________1______________________1__________1
1__________1______________________1__________1
1__________1______________________1__________1
1__________1______________________1__________1
1__________1______________________1__________1
1__________1______________________1__________1
1__________1______________________1__________1
1__________1______________________1__________1
1___3__3___1______________________1___3__3___1
11111__11111______________________11111__11111
____1__1______________________________1__1____
____1__1______________________________1__1____
____1__1______________________________1__1____
____1__1______________________________1__1____
____1__1______________________________1__1____
11111__11111_____111111111111_____11111__11111
1___3__3___1_____1__________1_____1___3__3___1
1__________1_____1__________1_____1__________1
1__________1_____1__________1_____1__________1
1_________311111113________311111113_________1
1____________________________________________1
1____________________________________________1
1_________311111113________311111113_________1
1__________1_____1__________1_____1__________1
1__________1_____1__________1_____1__________1
1__________1_____1__________1_____1__________1
111111111111_____111111111111_____111111111111