1111111111111111111111111111111111111111111111
1__________1111111__________1111111__________1
1_33_______1111111__________1111111__________1
1_3________1111111___3__3___1111111____33____1
1_________511111115________511111115_________1
1_________________________________________3__1
1_________________________________________3__1
1_________511111115________511111115_________1
1________3_1111111___3__3___1111111__________1
1_______33_1111111__________1111111__________1
1___5__5___1111111__________1111111___5__5___1
11111__11111111111111111111111111111111__11111
11111__11111111111111111111111111111111__11111
11111__11111111111111111111111111111111__11111
11111__11111111111111111111111111111111__11111
11111__11111111111111111111111111111111__11111
11111__11111111111111111111111111111111__11111
11111__11111111111111111111111111111111__11111
1___5__5___111111111111111111111111___5__5___1
1__________111111111111111111111111_3______3_1
1__________111111111111111111111111__3____3__1
1__3____3__111111111111111111111111__________1
1__3____3__111111111111111111111111__________1
1__3____3__111111111111111111111111__________1
1__3____3__111111111111111111111111__________1
1__________111111111111111111111111__3____3__1
1__________111111111111111111111111_3______3_1
1___5__5___111111111111111111111111___5__5___1
11111__11111111111111111111111111111111__11111
11111__11111111111111111111111111111111__11111
11111__11111111111111111111111111111111__11111
11111__11111111111111111111111111111111__11111
11111__11111111111111111111111111111111__11111
11111__11111111111111111111111111111111__11111
11111__11111111111111111111111111111111__11111
1___5__5___1111111__________1111111___5__5___1
1_33____33_1111111______33__1111111__________1
1_3______3_1111111_______3__1111111__33__33__1
1_________511111115________511111115_________1
1____________________________________________1
1____________________________________________1
1___3__3__511111115________511111115_________1
1___3__3___1111111_3________1111111____33____1
1___3333___1111111_33_______1111111__________1
1__________1111111__________1111111__________1
1111111111111111111111111111111111111111111111