1111111111111111111111111111111111111111111111
1__________1111111__________1111111__________1
1__________1111111__________1111111__________1
1__________1111111__________1111111__________1
1_________311111113________311111113_________1
1____________________________________________1
1____________________________________________1
1_________311111113________311111113_________1
1__________1111111__________1111111__________1
1__________1111111__________1111111__________1
1___3__3___1111111__________1111111___3__3___1
11111__11111111111111111111111111111111__11111
11111__11111111111111111111111111111111__11111
11111__11111111111111111111111111111111__11111
11111__11111111111111111111111111111111__11111
11111__11111111111111111111111111111111__11111
11111__11111111111111111111111111111111__11111
11111__11111111111111111111111111111111__11111
1___3__3___111111111111111111111111___3__3___1
1__________111111111111111111111111__________1
1__________111111111111111111111111__________1
1__________111111111111111111111111__________1
1__________111111111111111111111111__________1
1__________111111111111111111111111__________1
1__________111111111111111111111111__________1
1__________111111111111111111111111__________1
1__________111111111111111111111111__________1
1___3__3___111111111111111111111111___3__3___1
11111__11111111111111111111111111111111__11111
11111__11111111111111111111111111111111__11111
11111__11111111111111111111111111111111__11111
11111__11111111111111111111111111111111__11111
11111__11111111111111111111111111111111__11111
11111__11111111111111111111111111111111__11111
11111__11111111111111111111111111111111__11111
1___3__3___1111111__________1111111___3__3___1
1__________1111111__________1111111__________1
1__________1111111__________1111111__________1
1_________311111113________311111113_________1
1____________________________________________1
1____________________________________________1
1_________311111113________311111113_________1
1__________1111111__________1111111__________1
1__________1111111__________1111111__________1
1__________1111111__________1111111__________1
1111111111111111111111111111111111111111111111