_________________222222222222_________________
_________________2__________2_________________
_________________2______22__2_________________
_________________2_______2__2_________________
_________________2__________2_________________
_________________2__________2_________________
_________________2__________2_________________
_________________2__2_______2_________________
_________________2__22______2_________________
_________________2___5__5___2_________________
_________________22222__22222_________________
_____________________2__2_____________________
_____________________2__2_____________________
_____________________2__2_____________________
_____________________2__2_____________________
_____________________2__2_____________________
222222222222_____22222__22222_____222222222222
2__________2_____22__5__5__22_____2__________2
2__222222__2_____2_2______2_2_____2__22___2__2
2__2____2__2_____2__2____2__2_____2__22______2
2_________52222222__________22222225_________2
2____________________________________________2
2____________________________________________2
2_________52222222__________22222225_________2
2__2____2__2_____2__2____2__2_____2______22__2
2__222222__2_____2_2______2_2_____2__2___22__2
2__________2_____22__5__5__22_____2__________2
222222222222_____22222__22222_____222222222222
_____________________2__2_____________________
_____________________2__2_____________________
_____________________2__2_____________________
_____________________2__2_____________________
_____________________2__2_____________________
_________________22222__22222_________________
_________________2___5__5___2_________________
_________________2__________2_________________
_________________2___2222___2_________________
_________________2__________2_________________
_________________2__________2_________________
_________________2__________2_________________
_________________2__________2_________________
_________________2___2222___2_________________
_________________2__________2_________________
_________________222222222222_________________