_________________222222222222_________________
_________________2__________2_________________
_________________2__________2_________________
_________________2__________2_________________
_________________2__________2_________________
_________________2__________2_________________
_________________2__________2_________________
_________________2__________2_________________
_________________2__________2_________________
_________________2__________2_________________
_________________22222__22222_________________
_____________________2__2_____________________
_____________________2__2_____________________
_____________________2__2_____________________
_____________________2__2_____________________
_____________________2__2_____________________
222222222222_____22222__22222_____222222222222
2__________2_____2__________2_____2__________2
2__________2_____2__________2_____2__________2
2__________2_____2__________2_____2__________2
2__________2222222__________2222222__________2
2____________________________________________2
2____________________________________________2
2__________2222222__________2222222__________2
2__________2_____2__________2_____2__________2
2__________2_____2__________2_____2__________2
2__________2_____2__________2_____2__________2
222222222222_____22222__22222_____222222222222
_____________________2__2_____________________
_____________________2__2_____________________
_____________________2__2_____________________
_____________________2__2_____________________
_____________________2__2_____________________
_________________22222__22222_________________
_________________2__________2_________________
_________________2__________2_________________
_________________2__________2_________________
_________________2__________2_________________
_________________2__________2_________________
_________________2__________2_________________
_________________2__________2_________________
_________________2__________2_________________
_________________2__________2_________________
_________________222222222222_________________